Eva Maria Cella Dal Chiavon - Casa Civil
Eugênio José Guilherme de Aragão - Ministerio da Justiça
Aldo Rebelo - Ministério da Defesa
Mauro Vieira - Ministério das Relações Exteriores
Nelson Barbosa - Ministério da Fazenda
Antonio Carlos Rodrigues - Ministério dos Transportes
Kátia Abreu - Ministério da Agricultura, Pecuária e Abastecimento
Aloizio Mercadante - Ministério da Educação
João Luiz Silva Ferreira - Ministério da Cultura
Miguel Rossetto - Ministério do Trabalho e Previdência Social 
Tereza Campello - Ministério do Desenvolvimento Social e Combate à Fome 
Marcelo Castro - Ministério da Saúde 
Armando Monteiro Neto - Ministério do Desenvolvimento, Indústria e Comércio Exterior 
Marco Antonio Martins Almeida - Ministério de Minas e Energia 
Valdir Simão - Ministério do Planejamento, Orçamento e Gestão
André Figueiredo - Ministério das Comunicações 
Emília Maria Silva Ribeiro Curi - Ministério da Ciência, Tecnologia e Inovação 
Izabella Teixeira - Ministério do Meio Ambiente 
Ricardo Leyser - Ministério do Esporte 
Alessandro Golombiewski Teixeira - Ministério do Turismo 
Josélio de Andrade Moura - Ministério da Integração Nacional 
Patrus Ananias - Ministério do Desenvolvimento Agrário 
Inês da Silva Magalhães - Ministério das Cidades 
Nilma Lino Gomes - Ministério das Mulheres, Igualdade Racial, da Juventude e dos Direitos Humanos 
Ricardo Berzoini - Secretaria de Governo da Presidência da República 
José Eduardo Cardozo - Advocacia-Geral da União 
Luiz Navarro de Brito - Controladoria-Geral da União 
Alexandre Tombini - Banco Central do Brasil 
Edinho Silva - Secretaria de Comunicação Social da Presidência da República 
Maurício Muniz Barretto de Carvalho - Secretaria de Portos da Presidência da República 
Guilherme Walder Mora Ramalho - Secretaria de Aviação Civil da Presidência da República 
